air,date,hr,subhr,vmc,runway,dep,arr,oper
SFO,6/1/13,0,1,VMC,"28L, 28R | 28L, 28R",3,4,7
SFO,6/1/13,0,2,VMC,"28L, 28R | 28L, 28R",2,2,4
SFO,6/1/13,0,3,VMC,"28L, 28R | 28L, 28R",2,1,3
SFO,6/1/13,0,4,VMC,"28L, 28R | 28L, 28R",2,2,4
SFO,6/1/13,1,1,VMC,"28L, 28R | 28L, 28R",2,0,2
SFO,6/1/13,1,2,VMC,"28L, 28R | 28L, 28R",2,0,2
SFO,6/1/13,1,3,VMC,"28L, 28R | 28L, 28R",0,1,1
SFO,6/1/13,1,4,VMC,"28L, 28R | 28L, 28R",2,0,2
SFO,6/1/13,2,1,VMC,"28L, 28R | 28L, 28R",1,0,1
SFO,6/1/13,2,2,VMC,"28L, 28R | 28L, 28R",1,0,1
SFO,6/1/13,2,3,VMC,"28L, 28R | 28L, 28R",0,0,0
SFO,6/1/13,2,4,VMC,"28L, 28R | 28L, 28R",0,0,0
SFO,6/1/13,3,1,VMC,"28L, 28R | 28L, 28R",1,0,1
SFO,6/1/13,3,2,VMC,"28L, 28R | 28L, 28R",0,0,0
SFO,6/1/13,3,3,VMC,"28L, 28R | 28L, 28R",1,1,2
SFO,6/1/13,3,4,VMC,"28L, 28R | 28L, 28R",0,0,0
SFO,6/1/13,4,1,VMC,"28L, 28R | 28L, 28R",1,0,1
SFO,6/1/13,4,2,VMC,"28L, 28R | 28L, 28R",0,0,0
SFO,6/1/13,4,3,VMC,"28L, 28R | 28L, 28R",0,1,1
SFO,6/1/13,4,4,VMC,"28L, 28R | 28L, 28R",0,1,1
SFO,6/1/13,5,1,VMC,"28L, 28R | 28L, 28R",0,1,1
SFO,6/1/13,5,2,VMC,28R | 1R,0,0,0
SFO,6/1/13,5,3,VMC,28R | 1R,2,0,2
SFO,6/1/13,5,4,VMC,28R | 1R,0,3,3
SFO,6/1/13,6,1,VMC,28R | 1R,3,2,5
SFO,6/1/13,6,2,VMC,28R | 1R,7,1,8
SFO,6/1/13,6,3,VMC,28R | 1R,5,2,7
SFO,6/1/13,6,4,VMC,28R | 1R,5,5,10
SFO,6/1/13,7,1,VMC,28R | 1R,9,8,17
SFO,6/1/13,7,2,VMC,28R | 1R,10,7,17
SFO,6/1/13,7,3,VMC,28R | 1R,6,6,12
SFO,6/1/13,7,4,VMC,28R | 1R,5,4,9
SFO,6/1/13,8,1,VMC,"28L, 28R | 1L, 1R",7,10,17
SFO,6/1/13,8,2,VMC,"28L, 28R | 1L, 1R",10,8,18
SFO,6/1/13,8,3,VMC,"28L, 28R | 1L, 1R",15,3,18
SFO,6/1/13,8,4,VMC,"28L, 28R | 1L, 1R",6,7,13
SFO,6/1/13,9,1,VMC,"28L, 28R | 1L, 1R",7,11,18
SFO,6/1/13,9,2,VMC,"28L, 28R | 1L, 1R",11,9,20
SFO,6/1/13,9,3,VMC,"28L, 28R | 1L, 1R",8,12,20
SFO,6/1/13,9,4,VMC,"28L, 28R | 1L, 1R",8,6,14
SFO,6/1/13,10,1,VMC,"28L, 28R | 1L, 1R",4,8,12
SFO,6/1/13,10,2,VMC,"28L, 28R | 1L, 1R",3,6,9
SFO,6/1/13,10,3,VMC,"28L, 28R | 1L, 1R",4,12,16
SFO,6/1/13,10,4,VMC,"28L, 28R | 1L, 1R",14,8,22
SFO,6/1/13,11,1,VMC,"28L, 28R | 1L, 1R",11,13,24
SFO,6/1/13,11,2,VMC,"28L, 28R | 1L, 1R",14,8,22
SFO,6/1/13,11,3,VMC,"28L, 28R | 1L, 1R",9,9,18
SFO,6/1/13,11,4,VMC,"28L, 28R | 1L, 1R",8,15,23
SFO,6/1/13,12,1,VMC,"28L, 28R | 1L, 1R",10,5,15
SFO,6/1/13,12,2,VMC,"28L, 28R | 1L, 1R",5,8,13
SFO,6/1/13,12,3,VMC,"28L, 28R | 1L, 1R",7,8,15
SFO,6/1/13,12,4,VMC,"28L, 28R | 1L, 1R",6,7,13
SFO,6/1/13,13,1,VMC,"28L, 28R | 1L, 1R",11,11,22
SFO,6/1/13,13,2,VMC,"28L, 28R | 1L, 1R",19,6,25
SFO,6/1/13,13,3,VMC,"28L, 28R | 1L, 1R",7,8,15
SFO,6/1/13,13,4,VMC,"28L, 28R | 1L, 1R",13,7,20
SFO,6/1/13,14,1,VMC,"28L, 28R | 1L, 1R",7,3,10
SFO,6/1/13,14,2,VMC,"28L, 28R | 1L, 1R",11,7,18
SFO,6/1/13,14,3,VMC,"28L, 28R | 28L, 28R",9,7,16
SFO,6/1/13,14,4,VMC,"28L, 28R | 28L, 28R",8,7,15
SFO,6/1/13,15,1,VMC,"28L, 28R | 28L, 28R",4,11,15
SFO,6/1/13,15,2,VMC,"28L, 28R | 28L, 28R",8,6,14
SFO,6/1/13,15,3,VMC,"28L, 28R | 28L, 28R",7,6,13
SFO,6/1/13,15,4,VMC,"28L, 28R | 28L, 28R",5,8,13
SFO,6/1/13,16,1,VMC,"28L, 28R | 28L, 28R",7,8,15
SFO,6/1/13,16,2,VMC,"28L, 28R | 28L, 28R",11,6,17
SFO,6/1/13,16,3,VMC,"28L, 28R | 28L, 28R",8,6,14
SFO,6/1/13,16,4,VMC,"28L, 28R | 28L, 28R",6,8,14
SFO,6/1/13,17,1,VMC,"28L, 28R | 28L, 28R",8,8,16
SFO,6/1/13,17,2,VMC,"28L, 28R | 28L, 28R",4,5,9
SFO,6/1/13,17,3,VMC,"28L, 28R | 28L, 28R",8,5,13
SFO,6/1/13,17,4,VMC,"28L, 28R | 28L, 28R",3,7,10
SFO,6/1/13,18,1,VMC,"28L, 28R | 28L, 28R",7,8,15
SFO,6/1/13,18,2,VMC,"28L, 28R | 28L, 28R",3,7,10
SFO,6/1/13,18,3,VMC,"28L, 28R | 28L, 28R",2,10,12
SFO,6/1/13,18,4,VMC,"28L, 28R | 28L, 28R",4,9,13
SFO,6/1/13,19,1,VMC,"28L, 28R | 28L, 28R",2,8,10
SFO,6/1/13,19,2,VMC,"28L, 28R | 28L, 28R",6,5,11
SFO,6/1/13,19,3,VMC,"28L, 28R | 28L, 28R",7,6,13
SFO,6/1/13,19,4,VMC,"28L, 28R | 28L, 28R",9,5,14
SFO,6/1/13,20,1,VMC,"28L, 28R | 28L, 28R",6,3,9
SFO,6/1/13,20,2,VMC,"28L, 28R | 28L, 28R",3,12,15
SFO,6/1/13,20,3,VMC,"28L, 28R | 28L, 28R",3,8,11
SFO,6/1/13,20,4,VMC,"28L, 28R | 28L, 28R",0,9,9
SFO,6/1/13,21,1,VMC,"28L, 28R | 28L, 28R",3,8,11
SFO,6/1/13,21,2,VMC,"28L, 28R | 28L, 28R",7,10,17
SFO,6/1/13,21,3,VMC,"28L, 28R | 28L, 28R",5,3,8
SFO,6/1/13,21,4,VMC,"28L, 28R | 28L, 28R",0,6,6
SFO,6/1/13,22,1,VMC,"28L, 28R | 28L, 28R",2,7,9
SFO,6/1/13,22,2,VMC,"28R | 28L, 28R",4,5,9
SFO,6/1/13,22,3,VMC,"28R | 28L, 28R",6,4,10
SFO,6/1/13,22,4,VMC,"28R | 28L, 28R",8,3,11
SFO,6/1/13,23,1,VMC,"28R | 28L, 28R",8,4,12
SFO,6/1/13,23,2,VMC,"28R | 28L, 28R",8,1,9
SFO,6/1/13,23,3,VMC,"28R | 28L, 28R",3,2,5
SFO,6/1/13,23,4,VMC,"28R | 28L, 28R",2,4,6
SFO,6/2/13,0,1,VMC,"28R | 28L, 28R",2,0,2
SFO,6/2/13,0,2,VMC,"28R | 28L, 28R",2,1,3
SFO,6/2/13,0,3,VMC,"28R | 28L, 28R",1,2,3
SFO,6/2/13,0,4,VMC,"28R | 28L, 28R",1,1,2
SFO,6/2/13,1,1,VMC,"28R | 28L, 28R",2,0,2
SFO,6/2/13,1,2,VMC,"28R | 28L, 28R",2,0,2
SFO,6/2/13,1,3,VMC,"28R | 28L, 28R",2,0,2
SFO,6/2/13,1,4,VMC,"28R | 28L, 28R",2,1,3
SFO,6/2/13,2,1,VMC,"28R | 28L, 28R",0,0,0
SFO,6/2/13,2,2,VMC,"28R | 28L, 28R",0,0,0
SFO,6/2/13,2,3,VMC,"28R | 28L, 28R",0,0,0
SFO,6/2/13,2,4,VMC,"28R | 28L, 28R",1,0,1
SFO,6/2/13,3,1,VMC,"28R | 28L, 28R",1,0,1
SFO,6/2/13,3,2,VMC,"28R | 28L, 28R",0,0,0
SFO,6/2/13,3,3,VMC,"28R | 28L, 28R",1,0,1
SFO,6/2/13,3,4,VMC,"28R | 28L, 28R",0,0,0
SFO,6/2/13,4,1,VMC,"28R | 28L, 28R",0,0,0
SFO,6/2/13,4,2,VMC,"28R | 28L, 28R",0,1,1
SFO,6/2/13,4,3,VMC,"28R | 28L, 28R",0,0,0
SFO,6/2/13,4,4,VMC,"28R | 28L, 28R",0,1,1
SFO,6/2/13,5,1,VMC,"28R | 28L, 28R",0,2,2
SFO,6/2/13,5,2,VMC,"28R | 28L, 28R",0,0,0
SFO,6/2/13,5,3,VMC,"28R | 28L, 28R",0,0,0
SFO,6/2/13,5,4,VMC,"28R | 28L, 28R",1,2,3
SFO,6/2/13,6,1,VMC,"28R | 28L, 28R",5,4,9
SFO,6/2/13,6,2,VMC,"28R | 28L, 28R",6,1,7
SFO,6/2/13,6,3,VMC,"28R | 28L, 28R",6,4,10
SFO,6/2/13,6,4,VMC,"28R | 28L, 28R",5,5,10
SFO,6/2/13,7,1,VMC,"28L, 28R | 1L, 1R",8,7,15
SFO,6/2/13,7,2,VMC,"28L, 28R | 1L, 1R",7,3,10
SFO,6/2/13,7,3,VMC,"28L, 28R | 1L, 1R",6,7,13
SFO,6/2/13,7,4,VMC,"28L, 28R | 1L, 1R",5,6,11
SFO,6/2/13,8,1,VMC,"28L, 28R | 1L, 1R",5,9,14
SFO,6/2/13,8,2,VMC,"28L, 28R | 1L, 1R",13,7,20
SFO,6/2/13,8,3,VMC,"28L, 28R | 1L, 1R",10,4,14
SFO,6/2/13,8,4,VMC,"28L, 28R | 1L, 1R",10,9,19
SFO,6/2/13,9,1,VMC,"28L, 28R | 1L, 1R",4,13,17
SFO,6/2/13,9,2,VMC,"28L, 28R | 1L, 1R",11,10,21
SFO,6/2/13,9,3,VMC,"28L, 28R | 1L, 1R",13,10,23
SFO,6/2/13,9,4,VMC,"28L, 28R | 1L, 1R",8,8,16
SFO,6/2/13,10,1,VMC,"28L, 28R | 1L, 1R",6,8,14
SFO,6/2/13,10,2,VMC,"28L, 28R | 1L, 1R",2,9,11
SFO,6/2/13,10,3,VMC,"28L, 28R | 1L, 1R",10,9,19
SFO,6/2/13,10,4,VMC,"28L, 28R | 1L, 1R",11,11,22
SFO,6/2/13,11,1,VMC,"28L, 28R | 1L, 1R",16,5,21
SFO,6/2/13,11,2,VMC,"28L, 28R | 1L, 1R",11,8,19
SFO,6/2/13,11,3,VMC,"28L, 28R | 1L, 1R",8,13,21
SFO,6/2/13,11,4,VMC,"28L, 28R | 1L, 1R",10,11,21
SFO,6/2/13,12,1,VMC,"28L, 28R | 1L, 1R",5,8,13
SFO,6/2/13,12,2,VMC,"28L, 28R | 1L, 1R",8,9,17
SFO,6/2/13,12,3,VMC,"28L, 28R | 1L, 1R",6,8,14
SFO,6/2/13,12,4,VMC,"28L, 28R | 1L, 1R",11,9,20
SFO,6/2/13,13,1,VMC,"28L, 28R | 1L, 1R",7,12,19
SFO,6/2/13,13,2,VMC,"28L, 28R | 1L, 1R",14,11,25
SFO,6/2/13,13,3,VMC,"28L, 28R | 1L, 1R",11,8,19
SFO,6/2/13,13,4,VMC,"28L, 28R | 1L, 1R",13,5,18
SFO,6/2/13,14,1,VMC,"28L, 28R | 1L, 1R",10,6,16
SFO,6/2/13,14,2,VMC,"28L, 28R | 1L, 1R",11,8,19
SFO,6/2/13,14,3,VMC,"28L, 28R | 1L, 1R",9,8,17
SFO,6/2/13,14,4,VMC,"28L, 28R | 1L, 1R",10,12,22
SFO,6/2/13,15,1,VMC,"28L, 28R | 1L, 1R",8,7,15
SFO,6/2/13,15,2,VMC,"28L, 28R | 1L, 1R",12,4,16
SFO,6/2/13,15,3,VMC,"28L, 28R | 1L, 1R",7,5,12
SFO,6/2/13,15,4,VMC,"28L, 28R | 1L, 1R",7,6,13
SFO,6/2/13,16,1,VMC,"28L, 28R | 1L, 1R",12,8,20
SFO,6/2/13,16,2,VMC,"28L, 28R | 1L, 1R",7,13,20
SFO,6/2/13,16,3,VMC,"28L, 28R | 1L, 1R",10,8,18
SFO,6/2/13,16,4,VMC,"28L, 28R | 1L, 1R",10,6,16
SFO,6/2/13,17,1,VMC,"28L, 28R | 1L, 1R",8,6,14
SFO,6/2/13,17,2,VMC,"28L, 28R | 1L, 1R",10,11,21
SFO,6/2/13,17,3,VMC,"28L, 28R | 1L, 1R",9,5,14
SFO,6/2/13,17,4,VMC,"28L, 28R | 1L, 1R",6,5,11
SFO,6/2/13,18,1,VMC,"28L, 28R | 1L, 1R",5,10,15
SFO,6/2/13,18,2,VMC,"28L, 28R | 1L, 1R",5,8,13
SFO,6/2/13,18,3,VMC,"28L, 28R | 1L, 1R",4,14,18
SFO,6/2/13,18,4,VMC,"28L, 28R | 1L, 1R",1,10,11
SFO,6/2/13,19,1,VMC,"28L, 28R | 1L, 1R",9,9,18
SFO,6/2/13,19,2,VMC,"28L, 28R | 1L, 1R",11,3,14
SFO,6/2/13,19,3,VMC,"28L, 28R | 1L, 1R",10,8,18
SFO,6/2/13,19,4,VMC,"28L, 28R | 1L, 1R",11,8,19
SFO,6/2/13,20,1,VMC,"28L, 28R | 1L, 1R",4,11,15
SFO,6/2/13,20,2,VMC,"28L, 28R | 1L, 1R",6,9,15
SFO,6/2/13,20,3,VMC,"28L, 28R | 1L, 1R",5,14,19
SFO,6/2/13,20,4,VMC,"28L, 28R | 1L, 1R",4,9,13
SFO,6/2/13,21,1,VMC,"28L, 28R | 1L, 1R",7,12,19
SFO,6/2/13,21,2,VMC,"28L, 28R | 1L, 1R",5,11,16
SFO,6/2/13,21,3,VMC,"28L, 28R | 1L, 1R",8,5,13
SFO,6/2/13,21,4,VMC,"28L, 28R | 1L, 1R",3,9,12
SFO,6/2/13,22,1,VMC,"28L, 28R | 1L, 1R",7,6,13
SFO,6/2/13,22,2,VMC,"28R | 1L, 1R",3,8,11
SFO,6/2/13,22,3,VMC,"28R | 1L, 1R",7,7,14
SFO,6/2/13,22,4,VMC,"28R | 1L, 1R",10,5,15
SFO,6/2/13,23,1,VMC,"28R | 1L, 1R",9,10,19
SFO,6/2/13,23,2,VMC,"28R | 1L, 1R",7,6,13
SFO,6/2/13,23,3,VMC,"28R | 1L, 1R",8,5,13
SFO,6/2/13,23,4,VMC,"28R | 1L, 1R",5,4,9
SFO,6/3/13,0,1,VMC,"28R | 1L, 1R",2,2,4
SFO,6/3/13,0,2,VMC,"28R | 1L, 1R",2,2,4
SFO,6/3/13,0,3,VMC,"28R | 1L, 1R",1,1,2
SFO,6/3/13,0,4,VMC,"28R | 1L, 1R",6,1,7
SFO,6/3/13,1,1,VMC,"28R | 1L, 1R",2,0,2
SFO,6/3/13,1,2,VMC,"28R | 1L, 1R",2,0,2
SFO,6/3/13,1,3,VMC,"28R | 1L, 1R",1,4,5
SFO,6/3/13,1,4,VMC,"28R | 1L, 1R",3,0,3
SFO,6/3/13,2,1,VMC,"28R | 1L, 1R",0,0,0
SFO,6/3/13,2,2,VMC,"28R | 1L, 1R",0,0,0
SFO,6/3/13,2,3,VMC,"28R | 1L, 1R",0,1,1
SFO,6/3/13,2,4,VMC,"28R | 1L, 1R",0,2,2
SFO,6/3/13,3,1,VMC,"28R | 1L, 1R",0,0,0
SFO,6/3/13,3,2,VMC,"28R | 1L, 1R",0,0,0
SFO,6/3/13,3,3,VMC,"28R | 1L, 1R",0,1,1
SFO,6/3/13,3,4,VMC,"28R | 1L, 1R",0,2,2
SFO,6/3/13,4,1,VMC,"28R | 1L, 1R",0,0,0
SFO,6/3/13,4,2,VMC,"28R | 1L, 1R",0,0,0
SFO,6/3/13,4,3,VMC,"28R | 1L, 1R",0,2,2
SFO,6/3/13,4,4,VMC,"28R | 1L, 1R",1,0,1
SFO,6/3/13,5,1,VMC,"28R | 1L, 1R",0,0,0
SFO,6/3/13,5,2,VMC,"28R | 1L, 1R",1,0,1
SFO,6/3/13,5,3,VMC,"28R | 1L, 1R",2,0,2
SFO,6/3/13,5,4,VMC,"28R | 1L, 1R",1,1,2
SFO,6/3/13,6,1,VMC,"28L | 1L, 1R",6,3,9
SFO,6/3/13,6,2,VMC,"28L | 1L, 1R",8,1,9
SFO,6/3/13,6,3,VMC,"28L | 1L, 1R",6,3,9
SFO,6/3/13,6,4,IMC,"28L | 1L, 1R",9,5,14
SFO,6/3/13,7,1,IMC,"28L | 1L, 1R",13,7,20
SFO,6/3/13,7,2,IMC,"28L | 1L, 1R",8,7,15
SFO,6/3/13,7,3,IMC,"28L | 1L, 1R",4,8,12
SFO,6/3/13,7,4,IMC,"28L | 1L, 1R",6,7,13
SFO,6/3/13,8,1,IMC,"28L | 1L, 1R",10,7,17
SFO,6/3/13,8,2,VMC,"28L | 1L, 1R",9,7,16
SFO,6/3/13,8,3,VMC,"28L | 1L, 1R",13,7,20
SFO,6/3/13,8,4,VMC,"28L | 1L, 1R",8,8,16
SFO,6/3/13,9,1,VMC,"28L, 28R | 1L, 1R",7,10,17
SFO,6/3/13,9,2,VMC,"28L, 28R | 1L, 1R",9,7,16
SFO,6/3/13,9,3,VMC,"28L, 28R | 1L, 1R",9,10,19
SFO,6/3/13,9,4,VMC,"28L, 28R | 1L, 1R",12,6,18
SFO,6/3/13,10,1,VMC,"28L, 28R | 1L, 1R",4,7,11
SFO,6/3/13,10,2,VMC,"28L, 28R | 1L, 1R",7,12,19
SFO,6/3/13,10,3,VMC,"28L, 28R | 1L, 1R",8,12,20
SFO,6/3/13,10,4,VMC,"28L, 28R | 1L, 1R",9,13,22
SFO,6/3/13,11,1,VMC,"28L, 28R | 1L, 1R",14,13,27
SFO,6/3/13,11,2,VMC,"28L, 28R | 1L, 1R",9,13,22
SFO,6/3/13,11,3,VMC,"28L, 28R | 1L, 1R",10,10,20
SFO,6/3/13,11,4,VMC,"28L, 28R | 1L, 1R",7,11,18
SFO,6/3/13,12,1,VMC,"28L, 28R | 1L, 1R",9,10,19
SFO,6/3/13,12,2,VMC,"28L, 28R | 1L, 1R",11,11,22
SFO,6/3/13,12,3,VMC,"28L, 28R | 1L, 1R",9,9,18
SFO,6/3/13,12,4,VMC,"28L, 28R | 1L, 1R",9,12,21
SFO,6/3/13,13,1,VMC,"28L, 28R | 1L, 1R",15,11,26
SFO,6/3/13,13,2,VMC,"28L, 28R | 1L, 1R",8,10,18
SFO,6/3/13,13,3,VMC,"28L, 28R | 1L, 1R",14,5,19
SFO,6/3/13,13,4,VMC,"28L, 28R | 1L, 1R",8,4,12
SFO,6/3/13,14,1,VMC,"28L, 28R | 1L, 1R",10,10,20
SFO,6/3/13,14,2,VMC,"28L, 28R | 1L, 1R",11,7,18
SFO,6/3/13,14,3,VMC,"28L, 28R | 1L, 1R",8,12,20
SFO,6/3/13,14,4,VMC,"28L, 28R | 1L, 1R",12,10,22
SFO,6/3/13,15,1,VMC,"28L, 28R | 1L, 1R",8,12,20
SFO,6/3/13,15,2,VMC,"28L, 28R | 1L, 1R",8,9,17
SFO,6/3/13,15,3,VMC,"28L, 28R | 1L, 1R",8,3,11
SFO,6/3/13,15,4,VMC,"28L, 28R | 1L, 1R",4,8,12
SFO,6/3/13,16,1,VMC,"28L, 28R | 1L, 1R",10,13,23
SFO,6/3/13,16,2,VMC,"28L, 28R | 1L, 1R",14,6,20
SFO,6/3/13,16,3,VMC,"28L, 28R | 1L, 1R",8,7,15
SFO,6/3/13,16,4,VMC,"28L, 28R | 1L, 1R",9,5,14
SFO,6/3/13,17,1,VMC,"28L, 28R | 28L, 28R",5,10,15
SFO,6/3/13,17,2,VMC,"28L, 28R | 28L, 28R",4,8,12
SFO,6/3/13,17,3,VMC,"28L, 28R | 28L, 28R",8,6,14
SFO,6/3/13,17,4,VMC,"28L, 28R | 28L, 28R",7,6,13
SFO,6/3/13,18,1,VMC,"28L, 28R | 28L, 28R",7,8,15
SFO,6/3/13,18,2,VMC,"28L, 28R | 28L, 28R",10,11,21
SFO,6/3/13,18,3,VMC,"28L, 28R | 1L, 1R",3,12,15
SFO,6/3/13,18,4,VMC,"28L, 28R | 1L, 1R",3,13,16
SFO,6/3/13,19,1,VMC,"28L, 28R | 1L, 1R",5,12,17
SFO,6/3/13,19,2,VMC,"28L, 28R | 1L, 1R",11,8,19
SFO,6/3/13,19,3,VMC,"28L, 28R | 1L, 1R",10,6,16
SFO,6/3/13,19,4,VMC,"28L, 28R | 1L, 1R",11,7,18
SFO,6/3/13,20,1,VMC,"28L, 28R | 1L, 1R",10,7,17
SFO,6/3/13,20,2,VMC,"28L, 28R | 1L, 1R",3,12,15
SFO,6/3/13,20,3,VMC,"28L, 28R | 1L, 1R",4,11,15
SFO,6/3/13,20,4,VMC,"28L, 28R | 1L, 1R",6,9,15
SFO,6/3/13,21,1,VMC,"28L, 28R | 1L, 1R",9,12,21
SFO,6/3/13,21,2,VMC,"28L, 28R | 1L, 1R",5,15,20
SFO,6/3/13,21,3,VMC,"28L, 28R | 1L, 1R",6,11,17
SFO,6/3/13,21,4,VMC,"28L, 28R | 1L, 1R",6,4,10
SFO,6/3/13,22,1,VMC,"28L, 28R | 1L, 1R",5,4,9
SFO,6/3/13,22,2,VMC,"28L, 28R | 1L, 1R",5,6,11
SFO,6/3/13,22,3,VMC,"28L, 28R | 1L, 1R",7,8,15
SFO,6/3/13,22,4,VMC,"28L, 28R | 1L, 1R",8,5,13
SFO,6/3/13,23,1,VMC,"28L, 28R | 1L, 1R",10,7,17
SFO,6/3/13,23,2,VMC,"28L, 28R | 1L, 1R",6,5,11
SFO,6/3/13,23,3,VMC,"28L, 28R | 1L, 1R",3,2,5
SFO,6/3/13,23,4,VMC,"28L, 28R | 1L, 1R",4,5,9
SFO,6/4/13,0,1,VMC,"28L, 28R | 1L, 1R",2,1,3
SFO,6/4/13,0,2,VMC,"28L, 28R | 1L, 1R",3,1,4
SFO,6/4/13,0,3,VMC,"28L, 28R | 1L, 1R",3,2,5
SFO,6/4/13,0,4,VMC,"28L, 28R | 1L, 1R",3,0,3
SFO,6/4/13,1,1,VMC,"28L, 28R | 1L, 1R",2,1,3
SFO,6/4/13,1,2,VMC,"28L, 28R | 1L, 1R",1,1,2
SFO,6/4/13,1,3,VMC,"28L, 28R | 1L, 1R",1,0,1
SFO,6/4/13,1,4,VMC,"28L, 28R | 1L, 1R",2,0,2
SFO,6/4/13,2,1,VMC,"28L, 28R | 1L, 1R",1,0,1
SFO,6/4/13,2,2,VMC,"28L, 28R | 1L, 1R",0,0,0
SFO,6/4/13,2,3,VMC,"28L, 28R | 1L, 1R",0,0,0
SFO,6/4/13,2,4,VMC,"28L, 28R | 1L, 1R",1,0,1
SFO,6/4/13,3,1,VMC,"28L, 28R | 1L, 1R",0,0,0
SFO,6/4/13,3,2,VMC,"28L, 28R | 1L, 1R",0,0,0
SFO,6/4/13,3,3,VMC,"28L, 28R | 1L, 1R",1,0,1
SFO,6/4/13,3,4,VMC,"28L, 28R | 1L, 1R",0,0,0
SFO,6/4/13,4,1,VMC,"28L, 28R | 1L, 1R",1,0,1
SFO,6/4/13,4,2,VMC,"28L, 28R | 1L, 1R",0,0,0
SFO,6/4/13,4,3,VMC,"28L, 28R | 1L, 1R",0,1,1
SFO,6/4/13,4,4,VMC,"28L, 28R | 1L, 1R",0,0,0
SFO,6/4/13,5,1,VMC,"28L, 28R | 1L, 1R",0,2,2
SFO,6/4/13,5,2,VMC,"28L, 28R | 1L, 1R",0,2,2
SFO,6/4/13,5,3,VMC,"28L, 28R | 1L, 1R",0,0,0
SFO,6/4/13,5,4,VMC,"28L, 28R | 1L, 1R",1,2,3
SFO,6/4/13,6,1,VMC,"28L, 28R | 1L, 1R",8,3,11
SFO,6/4/13,6,2,IMC,28L | 28L,4,2,6
SFO,6/4/13,6,3,IMC,28L | 28L,7,1,8
SFO,6/4/13,6,4,IMC,28L | 28L,6,6,12
SFO,6/4/13,7,1,IMC,28L | 28L,11,8,19
SFO,6/4/13,7,2,IMC,28L | 28L,13,8,21
SFO,6/4/13,7,3,IMC,28L | 28L,10,8,18
SFO,6/4/13,7,4,IMC,28L | 28L,6,6,12
SFO,6/4/13,8,1,IMC,28L | 28L,10,5,15
SFO,6/4/13,8,2,IMC,"28R | 1L, 1R",12,8,20
SFO,6/4/13,8,3,IMC,"28R | 1L, 1R",12,6,18
SFO,6/4/13,8,4,IMC,"28R | 1L, 1R",11,8,19
SFO,6/4/13,9,1,IMC,"28R | 1L, 1R",8,7,15
SFO,6/4/13,9,2,IMC,"28R | 1L, 1R",8,8,16
SFO,6/4/13,9,3,IMC,"28R | 1L, 1R",10,6,16
SFO,6/4/13,9,4,IMC,"28R | 1L, 1R",8,7,15
SFO,6/4/13,10,1,VMC,"28R | 1L, 1R",7,8,15
SFO,6/4/13,10,2,VMC,"28R | 1L, 1R",2,9,11
SFO,6/4/13,10,3,VMC,"28R | 1L, 1R",7,8,15
SFO,6/4/13,10,4,VMC,"28R | 1L, 1R",12,8,20
SFO,6/4/13,11,1,VMC,"28R | 1L, 1R",12,8,20
SFO,6/4/13,11,2,VMC,"28R | 1L, 1R",11,8,19
SFO,6/4/13,11,3,VMC,"28R | 1L, 1R",6,9,15
SFO,6/4/13,11,4,VMC,"28L, 28R | 1L, 1R",5,13,18
SFO,6/4/13,12,1,VMC,"28L, 28R | 1L, 1R",8,12,20
SFO,6/4/13,12,2,VMC,"28L, 28R | 1L, 1R",7,15,22
SFO,6/4/13,12,3,VMC,"28L, 28R | 1L, 1R",8,13,21
SFO,6/4/13,12,4,VMC,"28L, 28R | 1L, 1R",8,16,24
SFO,6/4/13,13,1,VMC,"28L, 28R | 1L, 1R",12,10,22
SFO,6/4/13,13,2,VMC,"28L, 28R | 1L, 1R",8,16,24
SFO,6/4/13,13,3,VMC,"28L, 28R | 1L, 1R",17,8,25
SFO,6/4/13,13,4,VMC,"28L, 28R | 1L, 1R",8,5,13
SFO,6/4/13,14,1,VMC,"28L, 28R | 1L, 1R",12,5,17
SFO,6/4/13,14,2,VMC,"28L, 28R | 1L, 1R",14,7,21
SFO,6/4/13,14,3,VMC,"28L, 28R | 1L, 1R",14,12,26
SFO,6/4/13,14,4,VMC,"28L, 28R | 1L, 1R",10,4,14
SFO,6/4/13,15,1,VMC,"28L, 28R | 1L, 1R",5,14,19
SFO,6/4/13,15,2,VMC,"28L, 28R | 1L, 1R",11,8,19
SFO,6/4/13,15,3,VMC,"28L, 28R | 1L, 1R",10,8,18
SFO,6/4/13,15,4,VMC,"28L, 28R | 1L, 1R",7,9,16
SFO,6/4/13,16,1,VMC,"28L, 28R | 1L, 1R",9,7,16
SFO,6/4/13,16,2,VMC,"28L, 28R | 1L, 1R",11,6,17
SFO,6/4/13,16,3,VMC,"28L, 28R | 1L, 1R",9,11,20
SFO,6/4/13,16,4,VMC,"28L, 28R | 1L, 1R",10,5,15
SFO,6/4/13,17,1,VMC,"28L, 28R | 1L, 1R",8,8,16
SFO,6/4/13,17,2,VMC,"28L, 28R | 1L, 1R",6,9,15
SFO,6/4/13,17,3,VMC,"28L, 28R | 1L, 1R",2,9,11
SFO,6/4/13,17,4,VMC,"28L, 28R | 1L, 1R",6,5,11
SFO,6/4/13,18,1,VMC,"28L, 28R | 1L, 1R",5,10,15
SFO,6/4/13,18,2,VMC,"28L, 28R | 1L, 1R",6,11,17
SFO,6/4/13,18,3,VMC,"28L, 28R | 1L, 1R",9,14,23
SFO,6/4/13,18,4,VMC,"28L, 28R | 1L, 1R",3,10,13
SFO,6/4/13,19,1,VMC,"28L, 28R | 1L, 1R",6,12,18
SFO,6/4/13,19,2,VMC,"28L, 28R | 1L, 1R",11,6,17
SFO,6/4/13,19,3,VMC,"28L, 28R | 1L, 1R",11,4,15
SFO,6/4/13,19,4,VMC,"28L, 28R | 1L, 1R",10,10,20
SFO,6/4/13,20,1,VMC,"28L, 28R | 1L, 1R",4,9,13
SFO,6/4/13,20,2,VMC,"28L, 28R | 1L, 1R",5,11,16
SFO,6/4/13,20,3,VMC,"28L, 28R | 1L, 1R",3,10,13
SFO,6/4/13,20,4,VMC,"28L, 28R | 1L, 1R",3,14,17
SFO,6/4/13,21,1,VMC,"28L, 28R | 1L, 1R",10,13,23
SFO,6/4/13,21,2,VMC,"28L, 28R | 1L, 1R",4,10,14
SFO,6/4/13,21,3,VMC,"28L, 28R | 1L, 1R",6,11,17
SFO,6/4/13,21,4,VMC,"28L, 28R | 1L, 1R",3,9,12
SFO,6/4/13,22,1,VMC,"28L, 28R | 1L, 1R",8,4,12
SFO,6/4/13,22,2,VMC,"28L, 28R | 1L, 1R",4,6,10
SFO,6/4/13,22,3,VMC,"28L, 28R | 1L, 1R",4,5,9
SFO,6/4/13,22,4,VMC,"28L, 28R | 1L, 1R",9,5,14
SFO,6/4/13,23,1,VMC,"28L, 28R | 1L, 1R",13,8,21
SFO,6/4/13,23,2,VMC,"28L, 28R | 1L, 1R",9,3,12
SFO,6/4/13,23,3,VMC,"28L, 28R | 1L, 1R",2,3,5
SFO,6/4/13,23,4,VMC,"28L, 28R | 1L, 1R",5,2,7
SFO,6/5/13,0,1,VMC,"28L, 28R | 1L, 1R",2,1,3
SFO,6/5/13,0,2,VMC,"28L, 28R | 1L, 1R",3,1,4
SFO,6/5/13,0,3,VMC,"28L, 28R | 1L, 1R",0,1,1
SFO,6/5/13,0,4,VMC,"28L, 28R | 1L, 1R",1,1,2
SFO,6/5/13,1,1,VMC,"28L, 28R | 1L, 1R",2,2,4
SFO,6/5/13,1,2,IMC,"28L, 28R | 1L, 1R",3,0,3
SFO,6/5/13,1,3,IMC,"28L, 28R | 1L, 1R",2,1,3
SFO,6/5/13,1,4,IMC,"28L, 28R | 1L, 1R",1,0,1
SFO,6/5/13,2,1,IMC,"28L, 28R | 1L, 1R",1,0,1
SFO,6/5/13,2,2,IMC,"28L, 28R | 1L, 1R",1,0,1
SFO,6/5/13,2,3,IMC,"28L, 28R | 1L, 1R",0,0,0
SFO,6/5/13,2,4,IMC,"28L, 28R | 1L, 1R",1,2,3
SFO,6/5/13,3,1,IMC,"28L, 28R | 1L, 1R",1,0,1
SFO,6/5/13,3,2,IMC,"28L, 28R | 1L, 1R",1,0,1
SFO,6/5/13,3,3,IMC,"28L, 28R | 1L, 1R",0,0,0
SFO,6/5/13,3,4,IMC,"28L, 28R | 1L, 1R",0,0,0
SFO,6/5/13,4,1,IMC,"28L, 28R | 1L, 1R",0,0,0
SFO,6/5/13,4,2,IMC,"28L, 28R | 1L, 1R",0,0,0
SFO,6/5/13,4,3,IMC,"28L, 28R | 1L, 1R",0,1,1
SFO,6/5/13,4,4,IMC,"28L, 28R | 1L, 1R",0,0,0
SFO,6/5/13,5,1,IMC,"28L, 28R | 1L, 1R",0,1,1
SFO,6/5/13,5,2,IMC,"28L, 28R | 1L, 1R",0,1,1
SFO,6/5/13,5,3,IMC,"28L, 28R | 1L, 1R",1,2,3
SFO,6/5/13,5,4,IMC,"28L, 28R | 1L, 1R",0,1,1
SFO,6/5/13,6,1,IMC,"28L | 1L, 1R",6,5,11
SFO,6/5/13,6,2,IMC,"28L | 1L, 1R",6,1,7
SFO,6/5/13,6,3,IMC,"28L | 1L, 1R",8,2,10
SFO,6/5/13,6,4,IMC,"28L | 1L, 1R",11,5,16
SFO,6/5/13,7,1,IMC,"28L | 1L, 1R",12,6,18
SFO,6/5/13,7,2,IMC,"28L | 1L, 1R",11,8,19
SFO,6/5/13,7,3,IMC,"28L | 1L, 1R",4,6,10
SFO,6/5/13,7,4,IMC,"28L | 1L, 1R",4,8,12
SFO,6/5/13,8,1,IMC,"28L | 1L, 1R",9,7,16
SFO,6/5/13,8,2,IMC,"28R | 1L, 1R",13,6,19
SFO,6/5/13,8,3,IMC,"28R | 1L, 1R",12,8,20
SFO,6/5/13,8,4,IMC,"28R | 1L, 1R",10,7,17
SFO,6/5/13,9,1,IMC,"28R | 1L, 1R",6,6,12
SFO,6/5/13,9,2,IMC,"28R | 1L, 1R",10,8,18
SFO,6/5/13,9,3,IMC,"28R | 1L, 1R",14,9,23
SFO,6/5/13,9,4,IMC,"28R | 1L, 1R",2,7,9
SFO,6/5/13,10,1,IMC,"28R | 1L, 1R",4,8,12
SFO,6/5/13,10,2,VMC,"28R | 1L, 1R",6,6,12
SFO,6/5/13,10,3,VMC,"28R | 1L, 1R",6,8,14
SFO,6/5/13,10,4,VMC,"28R | 1L, 1R",10,8,18
SFO,6/5/13,11,1,VMC,"28L, 28R | 1L, 1R",12,10,22
SFO,6/5/13,11,2,VMC,"28L, 28R | 1L, 1R",12,6,18
SFO,6/5/13,11,3,VMC,"28L, 28R | 1L, 1R",11,8,19
SFO,6/5/13,11,4,VMC,"28L, 28R | 1L, 1R",7,8,15
SFO,6/5/13,12,1,VMC,"28L, 28R | 1L, 1R",4,12,16
SFO,6/5/13,12,2,VMC,"28L, 28R | 1L, 1R",9,11,20
SFO,6/5/13,12,3,VMC,"28L, 28R | 1L, 1R",8,11,19
SFO,6/5/13,12,4,VMC,"28L, 28R | 1L, 1R",8,14,22
SFO,6/5/13,13,1,VMC,"28L, 28R | 1L, 1R",10,15,25
SFO,6/5/13,13,2,VMC,"28L, 28R | 1L, 1R",10,14,24
SFO,6/5/13,13,3,VMC,"28L, 28R | 1L, 1R",10,14,24
SFO,6/5/13,13,4,VMC,"28L, 28R | 1L, 1R",14,6,20
SFO,6/5/13,14,1,VMC,"28L, 28R | 1L, 1R",15,6,21
SFO,6/5/13,14,2,VMC,"28L, 28R | 1L, 1R",17,6,23
SFO,6/5/13,14,3,VMC,"28L, 28R | 1L, 1R",9,9,18
SFO,6/5/13,14,4,VMC,"28L, 28R | 1L, 1R",9,10,19
SFO,6/5/13,15,1,VMC,"28L, 28R | 1L, 1R",8,12,20
SFO,6/5/13,15,2,VMC,"28L, 28R | 1L, 1R",11,8,19
SFO,6/5/13,15,3,VMC,"28L, 28R | 1L, 1R",7,7,14
SFO,6/5/13,15,4,VMC,"28L, 28R | 1L, 1R",7,8,15
SFO,6/5/13,16,1,VMC,"28L, 28R | 1L, 1R",9,7,16
SFO,6/5/13,16,2,VMC,"28L, 28R | 1L, 1R",14,11,25
SFO,6/5/13,16,3,VMC,"28L, 28R | 1L, 1R",8,5,13
SFO,6/5/13,16,4,VMC,"28L, 28R | 1L, 1R",5,8,13
SFO,6/5/13,17,1,VMC,"28L, 28R | 1L, 1R",10,8,18
SFO,6/5/13,17,2,VMC,"28L, 28R | 1L, 1R",6,9,15
SFO,6/5/13,17,3,VMC,"28L, 28R | 1L, 1R",9,9,18
SFO,6/5/13,17,4,VMC,"28L, 28R | 1L, 1R",9,6,15
SFO,6/5/13,18,1,VMC,"28L, 28R | 1L, 1R",5,8,13
SFO,6/5/13,18,2,VMC,"28L, 28R | 1L, 1R",8,10,18
SFO,6/5/13,18,3,VMC,"28L, 28R | 1L, 1R",7,13,20
SFO,6/5/13,18,4,VMC,"28L, 28R | 1L, 1R",1,11,12
SFO,6/5/13,19,1,VMC,"28L, 28R | 1L, 1R",6,10,16
SFO,6/5/13,19,2,VMC,"28L, 28R | 1L, 1R",10,11,21
SFO,6/5/13,19,3,VMC,"28L, 28R | 1L, 1R",13,6,19
SFO,6/5/13,19,4,VMC,"28L, 28R | 1L, 1R",8,6,14
SFO,6/5/13,20,1,VMC,"28L, 28R | 1L, 1R",5,10,15
SFO,6/5/13,20,2,VMC,"28L, 28R | 1L, 1R",3,10,13
SFO,6/5/13,20,3,VMC,"28L, 28R | 1L, 1R",5,7,12
SFO,6/5/13,20,4,VMC,"28L, 28R | 1L, 1R",5,13,18
SFO,6/5/13,21,1,VMC,"28L, 28R | 1L, 1R",8,12,20
SFO,6/5/13,21,2,VMC,"28L, 28R | 1L, 1R",4,10,14
SFO,6/5/13,21,3,VMC,"28L, 28R | 1L, 1R",7,10,17
SFO,6/5/13,21,4,VMC,"28L, 28R | 1L, 1R",2,8,10
SFO,6/5/13,22,1,VMC,"28L, 28R | 1L, 1R",7,5,12
SFO,6/5/13,22,2,VMC,"28L, 28R | 1L, 1R",4,7,11
SFO,6/5/13,22,3,VMC,"28L, 28R | 1L, 1R",6,13,19
SFO,6/5/13,22,4,VMC,"28L, 28R | 1L, 1R",8,5,13
SFO,6/5/13,23,1,VMC,"28L, 28R | 1L, 1R",8,4,12
SFO,6/5/13,23,2,VMC,"28L, 28R | 1L, 1R",11,4,15
SFO,6/5/13,23,3,VMC,"28L, 28R | 1L, 1R",3,3,6
SFO,6/5/13,23,4,VMC,"28L, 28R | 1L, 1R",4,2,6
SFO,6/6/13,0,1,VMC,"28L, 28R | 1L, 1R",2,4,6
SFO,6/6/13,0,2,VMC,"28L, 28R | 1L, 1R",3,1,4
SFO,6/6/13,0,3,VMC,"28L, 28R | 1L, 1R",2,3,5
SFO,6/6/13,0,4,IMC,"28L, 28R | 1L, 1R",2,1,3
SFO,6/6/13,1,1,IMC,"28L, 28R | 1L, 1R",0,0,0
SFO,6/6/13,1,2,IMC,"28L, 28R | 1L, 1R",2,0,2
SFO,6/6/13,1,3,IMC,"28L, 28R | 1L, 1R",3,0,3
SFO,6/6/13,1,4,IMC,"28L, 28R | 1L, 1R",1,0,1
SFO,6/6/13,2,1,IMC,"28L, 28R | 1L, 1R",2,0,2
SFO,6/6/13,2,2,VMC,"28L, 28R | 1L, 1R",0,0,0
SFO,6/6/13,2,3,VMC,"28L, 28R | 1L, 1R",1,0,1
SFO,6/6/13,2,4,IMC,"28L, 28R | 1L, 1R",0,0,0
SFO,6/6/13,3,1,IMC,"28L, 28R | 1L, 1R",1,0,1
SFO,6/6/13,3,2,IMC,"28L, 28R | 1L, 1R",0,0,0
SFO,6/6/13,3,3,IMC,"28L, 28R | 1L, 1R",0,0,0
SFO,6/6/13,3,4,IMC,"28L, 28R | 1L, 1R",0,0,0
SFO,6/6/13,4,1,IMC,"28L, 28R | 1L, 1R",0,0,0
SFO,6/6/13,4,2,IMC,"28L, 28R | 1L, 1R",0,0,0
SFO,6/6/13,4,3,IMC,"28L, 28R | 1L, 1R",0,1,1
SFO,6/6/13,4,4,IMC,"28L, 28R | 1L, 1R",0,1,1
SFO,6/6/13,5,1,IMC,"28L, 28R | 1L, 1R",0,0,0
SFO,6/6/13,5,2,IMC,"28L, 28R | 1L, 1R",0,1,1
SFO,6/6/13,5,3,IMC,"28L, 28R | 1L, 1R",0,2,2
SFO,6/6/13,5,4,IMC,"28L, 28R | 1L, 1R",1,3,4
SFO,6/6/13,6,1,IMC,"28L | 1L, 1R",9,3,12
SFO,6/6/13,6,2,IMC,"28L | 1L, 1R",10,2,12
SFO,6/6/13,6,3,IMC,"28L | 1L, 1R",6,3,9
SFO,6/6/13,6,4,IMC,"28L | 1L, 1R",6,7,13
SFO,6/6/13,7,1,IMC,"28L | 1L, 1R",12,8,20
SFO,6/6/13,7,2,IMC,"28L | 1L, 1R",10,7,17
SFO,6/6/13,7,3,IMC,"28L | 1L, 1R",6,6,12
SFO,6/6/13,7,4,IMC,"28L | 1L, 1R",7,3,10
SFO,6/6/13,8,1,IMC,"28L, 28R | 1L, 1R",11,6,17
SFO,6/6/13,8,2,IMC,"28L, 28R | 1L, 1R",14,6,20
SFO,6/6/13,8,3,IMC,"28L, 28R | 1L, 1R",15,6,21
SFO,6/6/13,8,4,IMC,"28L, 28R | 1L, 1R",4,7,11
SFO,6/6/13,9,1,IMC,"28L, 28R | 1L, 1R",7,8,15
SFO,6/6/13,9,2,IMC,"28L, 28R | 1L, 1R",9,8,17
SFO,6/6/13,9,3,IMC,"28L, 28R | 1L, 1R",9,8,17
SFO,6/6/13,9,4,VMC,"28L, 28R | 1L, 1R",11,7,18
SFO,6/6/13,10,1,VMC,"28L, 28R | 1L, 1R",6,8,14
SFO,6/6/13,10,2,VMC,"28L, 28R | 1L, 1R",6,7,13
SFO,6/6/13,10,3,VMC,"28L, 28R | 1L, 1R",6,9,15
SFO,6/6/13,10,4,VMC,"28L, 28R | 1L, 1R",5,10,15
SFO,6/6/13,11,1,VMC,"28L, 28R | 1L, 1R",10,14,24
SFO,6/6/13,11,2,VMC,"28L, 28R | 1L, 1R",12,11,23
SFO,6/6/13,11,3,VMC,"28L, 28R | 1L, 1R",10,12,22
SFO,6/6/13,11,4,VMC,"28L, 28R | 1L, 1R",11,10,21
SFO,6/6/13,12,1,VMC,"28L, 28R | 1L, 1R",10,10,20
SFO,6/6/13,12,2,VMC,"28L, 28R | 1L, 1R",9,12,21
SFO,6/6/13,12,3,VMC,"28L, 28R | 1L, 1R",7,14,21
SFO,6/6/13,12,4,VMC,"28L, 28R | 1L, 1R",10,15,25
SFO,6/6/13,13,1,VMC,"28L, 28R | 1L, 1R",8,14,22
SFO,6/6/13,13,2,VMC,"28L, 28R | 1L, 1R",10,14,24
SFO,6/6/13,13,3,VMC,"28L, 28R | 1L, 1R",13,10,23
SFO,6/6/13,13,4,VMC,"28L, 28R | 1L, 1R",17,5,22
SFO,6/6/13,14,1,VMC,"28L, 28R | 1L, 1R",18,6,24
SFO,6/6/13,14,2,VMC,"28L, 28R | 1L, 1R",11,6,17
SFO,6/6/13,14,3,VMC,"28L, 28R | 1L, 1R",10,8,18
SFO,6/6/13,14,4,VMC,"28L, 28R | 1L, 1R",9,13,22
SFO,6/6/13,15,1,VMC,"28L, 28R | 1L, 1R",11,9,20
SFO,6/6/13,15,2,VMC,"28L, 28R | 1L, 1R",9,8,17
SFO,6/6/13,15,3,VMC,"28L, 28R | 1L, 1R",9,7,16
SFO,6/6/13,15,4,VMC,"28L, 28R | 1L, 1R",6,8,14
SFO,6/6/13,16,1,VMC,"28L, 28R | 1L, 1R",9,12,21
SFO,6/6/13,16,2,VMC,"28L, 28R | 1L, 1R",14,8,22
SFO,6/6/13,16,3,VMC,"28L, 28R | 1L, 1R",9,8,17
SFO,6/6/13,16,4,VMC,"28L, 28R | 1L, 1R",7,8,15
SFO,6/6/13,17,1,VMC,"28L, 28R | 1L, 1R",9,8,17
SFO,6/6/13,17,2,VMC,"28L, 28R | 1L, 1R",8,7,15
SFO,6/6/13,17,3,VMC,"28L, 28R | 1L, 1R",8,6,14
SFO,6/6/13,17,4,VMC,"28L, 28R | 1L, 1R",7,6,13
SFO,6/6/13,18,1,VMC,"28L, 28R | 1L, 1R",5,13,18
SFO,6/6/13,18,2,VMC,"28L, 28R | 1L, 1R",12,12,24
SFO,6/6/13,18,3,VMC,"28L, 28R | 1L, 1R",2,10,12
SFO,6/6/13,18,4,VMC,"28L, 28R | 1L, 1R",7,10,17
SFO,6/6/13,19,1,VMC,"28L, 28R | 1L, 1R",8,9,17
SFO,6/6/13,19,2,VMC,"28L, 28R | 1L, 1R",13,11,24
SFO,6/6/13,19,3,VMC,"28L, 28R | 1L, 1R",12,4,16
SFO,6/6/13,19,4,VMC,"28L, 28R | 1L, 1R",5,9,14
SFO,6/6/13,20,1,VMC,"28L, 28R | 1L, 1R",11,13,24
SFO,6/6/13,20,2,VMC,"28L, 28R | 1L, 1R",7,10,17
SFO,6/6/13,20,3,VMC,"28L, 28R | 1L, 1R",4,12,16
SFO,6/6/13,20,4,VMC,"28L, 28R | 1L, 1R",7,12,19
SFO,6/6/13,21,1,VMC,"28L, 28R | 1L, 1R",7,11,18
SFO,6/6/13,21,2,VMC,"28L, 28R | 1L, 1R",7,6,13
SFO,6/6/13,21,3,VMC,"28L, 28R | 1L, 1R",6,12,18
SFO,6/6/13,21,4,VMC,"28L, 28R | 1L, 1R",7,12,19
SFO,6/6/13,22,1,VMC,"28L, 28R | 1L, 1R",5,12,17
SFO,6/6/13,22,2,VMC,"28L, 28R | 1L, 1R",1,13,14
SFO,6/6/13,22,3,VMC,"28L, 28R | 1L, 1R",5,12,17
SFO,6/6/13,22,4,VMC,"28L, 28R | 1L, 1R",12,6,18
SFO,6/6/13,23,1,VMC,"28L, 28R | 1L, 1R",9,2,11
SFO,6/6/13,23,2,VMC,"28L, 28R | 1L, 1R",11,6,17
SFO,6/6/13,23,3,VMC,"28L, 28R | 1L, 1R",9,3,12
SFO,6/6/13,23,4,VMC,"28L, 28R | 1L, 1R",6,4,10
SFO,6/7/13,0,1,VMC,"28L, 28R | 1L, 1R",3,2,5
SFO,6/7/13,0,2,VMC,"28L, 28R | 1L, 1R",1,4,5
SFO,6/7/13,0,3,VMC,"28L, 28R | 1L, 1R",2,1,3
SFO,6/7/13,0,4,VMC,"28L, 28R | 1L, 1R",3,3,6
SFO,6/7/13,1,1,VMC,"28L, 28R | 1L, 1R",3,0,3
SFO,6/7/13,1,2,VMC,"28L, 28R | 1L, 1R",0,0,0
SFO,6/7/13,1,3,VMC,"28L, 28R | 1L, 1R",2,0,2
SFO,6/7/13,1,4,VMC,"28L, 28R | 1L, 1R",1,0,1
SFO,6/7/13,2,1,VMC,"28L, 28R | 1L, 1R",2,0,2
SFO,6/7/13,2,2,VMC,"28L, 28R | 1L, 1R",1,0,1
SFO,6/7/13,2,3,VMC,"28L, 28R | 1L, 1R",0,0,0
SFO,6/7/13,2,4,IMC,"28L, 28R | 1L, 1R",0,1,1
SFO,6/7/13,3,1,IMC,"28L, 28R | 1L, 1R",1,0,1
SFO,6/7/13,3,2,IMC,"28L, 28R | 1L, 1R",1,0,1
SFO,6/7/13,3,3,IMC,"28L, 28R | 1L, 1R",0,0,0
SFO,6/7/13,3,4,IMC,"28L, 28R | 1L, 1R",0,0,0
SFO,6/7/13,4,1,IMC,"28L, 28R | 1L, 1R",0,1,1
SFO,6/7/13,4,2,IMC,"28L, 28R | 1L, 1R",0,0,0
SFO,6/7/13,4,3,IMC,"28L, 28R | 1L, 1R",0,0,0
SFO,6/7/13,4,4,IMC,"28L, 28R | 1L, 1R",0,0,0
SFO,6/7/13,5,1,IMC,"28L, 28R | 1L, 1R",0,1,1
SFO,6/7/13,5,2,IMC,"28L, 28R | 1L, 1R",0,1,1
SFO,6/7/13,5,3,IMC,"28L, 28R | 1L, 1R",0,1,1
SFO,6/7/13,5,4,IMC,"28L, 28R | 1L, 1R",0,4,4
SFO,6/7/13,6,1,IMC,"28L, 28R | 1L, 1R",5,5,10
SFO,6/7/13,6,2,IMC,"28R | 1L, 1R",8,4,12
SFO,6/7/13,6,3,IMC,"28R | 1L, 1R",10,4,14
SFO,6/7/13,6,4,IMC,"28R | 1L, 1R",9,6,15
SFO,6/7/13,7,1,IMC,"28R | 1L, 1R",11,7,18
SFO,6/7/13,7,2,IMC,"28R | 1L, 1R",11,7,18
SFO,6/7/13,7,3,IMC,"28R | 1L, 1R",7,7,14
SFO,6/7/13,7,4,IMC,"28R | 1L, 1R",11,6,17
SFO,6/7/13,8,1,IMC,"28R | 1L, 1R",7,7,14
SFO,6/7/13,8,2,IMC,"28R | 1L, 1R",12,7,19
SFO,6/7/13,8,3,IMC,"28R | 1L, 1R",11,8,19
SFO,6/7/13,8,4,IMC,"28R | 1L, 1R",11,7,18
SFO,6/7/13,9,1,IMC,"28R | 1L, 1R",6,9,15
SFO,6/7/13,9,2,IMC,"28R | 1L, 1R",8,8,16
SFO,6/7/13,9,3,VMC,"28R | 1L, 1R",7,8,15
SFO,6/7/13,9,4,VMC,"28L, 28R | 1L, 1R",10,8,18
SFO,6/7/13,10,1,VMC,"28L, 28R | 1L, 1R",6,8,14
SFO,6/7/13,10,2,VMC,"28L, 28R | 1L, 1R",3,8,11
SFO,6/7/13,10,3,VMC,"28L, 28R | 1L, 1R",5,10,15
SFO,6/7/13,10,4,VMC,"28L, 28R | 1L, 1R",8,13,21
SFO,6/7/13,11,1,VMC,"28L, 28R | 1L, 1R",11,11,22
SFO,6/7/13,11,2,VMC,"28L, 28R | 1L, 1R",12,12,24
SFO,6/7/13,11,3,VMC,"28L, 28R | 1L, 1R",12,13,25
SFO,6/7/13,11,4,VMC,"28L, 28R | 1L, 1R",7,12,19
SFO,6/7/13,12,1,VMC,"28L, 28R | 1L, 1R",10,11,21
SFO,6/7/13,12,2,VMC,"28L, 28R | 1L, 1R",12,12,24
SFO,6/7/13,12,3,VMC,"28L, 28R | 1L, 1R",8,10,18
SFO,6/7/13,12,4,VMC,"28L, 28R | 1L, 1R",14,10,24
SFO,6/7/13,13,1,VMC,"28L, 28R | 1L, 1R",12,13,25
SFO,6/7/13,13,2,VMC,"28L, 28R | 1L, 1R",9,6,15
SFO,6/7/13,13,3,VMC,"28L, 28R | 1L, 1R",10,7,17
SFO,6/7/13,13,4,VMC,"28L, 28R | 1L, 1R",7,7,14
SFO,6/7/13,14,1,VMC,"28L, 28R | 1L, 1R",14,6,20
SFO,6/7/13,14,2,VMC,"28L, 28R | 1L, 1R",8,7,15
SFO,6/7/13,14,3,VMC,"28L, 28R | 1L, 1R",5,15,20
SFO,6/7/13,14,4,VMC,"28L, 28R | 1L, 1R",14,10,24
SFO,6/7/13,15,1,VMC,"28L, 28R | 1L, 1R",8,8,16
SFO,6/7/13,15,2,VMC,"28L, 28R | 1L, 1R",13,7,20
SFO,6/7/13,15,3,VMC,"28L, 28R | 1L, 1R",12,7,19
SFO,6/7/13,15,4,VMC,"28L, 28R | 1L, 1R",10,8,18
SFO,6/7/13,16,1,VMC,"28L, 28R | 1L, 1R",13,5,18
SFO,6/7/13,16,2,VMC,"28L, 28R | 1L, 1R",11,5,16
SFO,6/7/13,16,3,VMC,"28L, 28R | 1L, 1R",11,6,17
SFO,6/7/13,16,4,VMC,"28L, 28R | 1L, 1R",5,9,14
SFO,6/7/13,17,1,VMC,"28L, 28R | 1L, 1R",6,10,16
SFO,6/7/13,17,2,VMC,"28L, 28R | 1L, 1R",8,8,16
SFO,6/7/13,17,3,VMC,"28L, 28R | 1L, 1R",4,9,13
SFO,6/7/13,17,4,VMC,"28L, 28R | 1L, 1R",7,5,12
SFO,6/7/13,18,1,VMC,"28L, 28R | 1L, 1R",7,9,16
SFO,6/7/13,18,2,VMC,"28L, 28R | 1L, 1R",8,11,19
SFO,6/7/13,18,3,VMC,"28L, 28R | 1L, 1R",6,9,15
SFO,6/7/13,18,4,VMC,"28L, 28R | 1L, 1R",5,14,19
SFO,6/7/13,19,1,VMC,"28L, 28R | 1L, 1R",7,8,15
SFO,6/7/13,19,2,VMC,"28L, 28R | 1L, 1R",11,10,21
SFO,6/7/13,19,3,VMC,"28L, 28R | 1L, 1R",12,7,19
SFO,6/7/13,19,4,VMC,"28L, 28R | 1L, 1R",7,8,15
SFO,6/7/13,20,1,VMC,"28L, 28R | 1L, 1R",8,11,19
SFO,6/7/13,20,2,VMC,"28L, 28R | 1L, 1R",8,11,19
SFO,6/7/13,20,3,VMC,"28L, 28R | 1L, 1R",6,13,19
SFO,6/7/13,20,4,VMC,"28L, 28R | 1L, 1R",7,7,14
SFO,6/7/13,21,1,VMC,"28L, 28R | 1L, 1R",9,11,20
SFO,6/7/13,21,2,VMC,"28L, 28R | 1L, 1R",5,12,17
SFO,6/7/13,21,3,VMC,"28L, 28R | 1L, 1R",8,13,21
SFO,6/7/13,21,4,VMC,"28L, 28R | 1L, 1R",7,10,17
SFO,6/7/13,22,1,VMC,"28L, 28R | 1L, 1R",3,6,9
SFO,6/7/13,22,2,VMC,"28L, 28R | 1L, 1R",4,8,12
SFO,6/7/13,22,3,VMC,"28L, 28R | 1L, 1R",6,12,18
SFO,6/7/13,22,4,VMC,"28L, 28R | 1L, 1R",7,7,14
SFO,6/7/13,23,1,VMC,"28L, 28R | 1L, 1R",12,6,18
SFO,6/7/13,23,2,VMC,"28L, 28R | 1L, 1R",10,6,16
SFO,6/7/13,23,3,VMC,"28L, 28R | 1L, 1R",11,1,12
SFO,6/7/13,23,4,VMC,"28L, 28R | 1L, 1R",6,4,10
